111111111111111111111111111111
1P000E000000000000000000000001
100000000000000000000000000001
1C0000000000000000000000000001
100000000000000000000000000001
10000000000000000000000H000001
100000000000000000000000000001
100000000000000000000000000001
100000000000000000000000000001
100000000000000000000000000001
100000000000000000000000000C01
111111111111111111111111111111
