111111111111111
1P0000000000011
1111111V11100E1
1C0000000000011
111111111111111
