111111111111111111111111111111
1P000100000000010000000001C0E1
10H0010H00100V0100H01000H1H001
10H00100H01000V1000H1H000100H1
1H00010H0010VV010H00100V010H01
1000H1000H1000010000100V01H001
100H010H001V000100H01000010H01
10H001H000100001H0001V000100H1
100H010H00100H0100H0100H010H01
1000H100H01000V1H000100001H001
1000000000100000000010H0000001
111111111111111111111111111111
